Nem szavaztam.	I kept my word.	False
- Még valamit? - Nem, ennyi volt az egész.	"""That bitch kicked me in the balls."" ""You deserved it."""	False
Merry fél a kutyáktól.	Peter is buying a tomcat.	False
Nagy nap ez a mai, fiam!	Today is a big day, son!	True
Linda nagyon szereti a csokoládét.	She wants him to be just a friend.	False
Na végre, hogy esik!	This is silly!	False
El fogom olvasni ezt a könyvet.	I'll read this book.	True
Végül a busz megállt.	The car broke down, so that we had to walk.	False
Úgy gondolom, még várhatnánk egy fél órát.	I think we should wait another half an hour.	True
A hozzászólásaid mindig nagyon hasznosak számomra.	This noise is unbearable.	False
Mi egy pár vagyunk.	We're a couple.	True
Két szép fia van.	He has two beautiful boys.	True
A fenébe! Nem találom a pénztárcámat.	I saw somebody steal the merchandise.	False
Nem tudtam, hová mehetnék.	I had no chance to escape.	False
Az élet csodaszép.	Life is a bitch.	False
Kötelező autót bérelni?	Is it obligatory to rent a car?	True
Nem vagyok az a trendi típus.	I'm not the trendy type.	True
Jó nap ez a mai!	Today is a big day, son!	False
Önök beszélnek oroszul?	Do you speak Russian?	True
A zene túl hangos.	The music is too loud.	True
Igaz, hogy művelt, de hiányzik belőle a bölcsesség.	It is true he is a learned man, but he lacks common sense.	True
Kérem, hogy hétfőn jöjjön.	It'll be forgotten in a few months' time.	False
Mindig elsőként nyílik panaszra a szája.	He felt ashamed about what he saw.	False
Mindenki azt akarja hallani, amit hallani akar.	Everyone wants to hear what everyone wants to hear.	True
Tom odaégette a borjút.	Tom got Mary to scratch the part of his back he couldn't reach.	False
Ha nincs hír, az jó hír.	There's no doubt: the universe is infinite.	False
Nem itta meg a tejet.	He ate a piece of the pie.	False
Két óra van.	I think we should wait another half an hour.	False
Ez mind miattad van.	That ship has sailed.	False
A kommunizmustól való félelem nagyon erős volt abban az időben.	Fear of communism was very strong at that time.	True
Tomi mindig panaszkodik, igaz?	Tom always complains, doesn't he?	True
Tom sokat beszél.	Just ignore Tom. He always seems to be complaining about something.	False
Mi történt ott pontosan?	How can we prove it actually happened?	False
Mi az ő foglalkozása?	Who was the first one here today?	False
Gondoltam, hogy talán akarnál enni valamit.	To tell the truth, I've already seen that movie.	False
Ez hülye!	This is silly!	True
Kell nekem egy bélyeg.	Give me the knife.	False
Szabad még egyszer hívnom téged?	Shall we watch the movie now?	False
Ez a szó nem található a listán.	This word is not found in the list.	True
Azt gondoltam, helyesen cselekszem.	To tell the truth, I've already seen that movie.	False
Nem hiszem el, hogy Tom igent mondott.	Tom said that he didn't see anything.	False
Te nem törődsz velem.	Don't tread on it.	False
Hívom az ügyvédemet.	Give me the knife.	False
Nem lesz ennek jó vége.	This isn't going to end well.	True
A csoki édes.	I like cracking sunflower seeds.	False
Csakugyan tetszik?	Can you believe Tom is still only thirteen?	False
A megjelenés kötelező.	It is unfortunately true.	False
Sokat jelent nekem.	Something is watching me.	False
Egy ember meghalt.	One person was killed.	True
Egyszer majd sajnálni fogod ezt.	To tell the truth, I've already seen that movie.	False
A világegyetem kétségtelenül végtelen.	There's no doubt: the universe is infinite.	True
Tomi halála után röviddel a felesége újraházasodott.	Tom's wife remarried shortly after his death.	True
A fia hét éve eltűnt.	His son disappeared seven years ago.	True
Azon az estén korán feküdtem le.	I heard this sentence on the street about an hour ago.	False
Biztos vagyok benne, hogy tetszik az új munkád.	There is nothing to be scared of.	False
George hasba vágta őt.	George hit him in the stomach.	True
a szexuális zaklatás komoly probléma lehet a munkahelyen.	Sexual harassment can be a serious problem in the workplace.	True
Nagyon szeretek síelni.	They are hungry.	False
Sírt-rítt.	I scratched my records.	False
Minden adandó alkalommal írok.	I meet Mihaela every morning at the subway.	False
A vihar még hevesebbé vált.	The storm became even more violent.	True
Tom éppen rám néz.	You got shot, Tom.	False
Japán tele van meglepetésekkel.	They are looking at only the sunny side of the American economy.	False
Látni akarjuk.	We want to see it.	True
Ausztrália fiataljainak nevében beszélünk.	We are speaking on behalf of the young people of Australia.	True
A fotót meghamisították.	The photograph was falsified.	True
Nagyon sürgős ez a dolog.	That's a depressing story.	False
Elolvadt a hógolyó a kezemben.	The snowball melted in my hand.	True
Mióta tanulsz eszperantóul?	Do you speak Russian?	False
Melyik iskolába jársz?	Where does your sister go to school?	False
Meg kellett volna vitatnod egy ügyvéddel.	I saw somebody steal the merchandise.	False
Tanulnod kellene.	Children love to dig in the sand.	False
Miért akarnál segíteni Tomon?	Why would you want to help Tom?	True
Házas vagyok.	You clean up.	False
Mikor látogatsz meg ismét?	Shall we watch the movie now?	False
Azt akarom, hogy szállj le rólam!	Give me that piece of paper, and I will inspect it!	False
Rá ne lépj!	Don't step on the broken glass.	False
Neki túl sok könyve van.	He has too many books.	True
Ez a szokásos eljárás.	It's standard procedure.	True
Gyere ki velem.	I will shoot him.	False
Mire kell neked ez az autó?	What are you going to use this car for?	True
Tom megint becsapott minket.	Tom tricked us again.	True
Ne felejtsd el ráírni az irányítószámot!	Don't forget to write the zip code.	True
A világ egy őrültek háza.	This world is just an insane asylum.	True
Csodálatos dolog Amerikában lenni, ha azért vagy itt, hogy pénzt keressél.	America is a lovely place to be, if you are here to earn money.	True
Ez egy lesújtó történet.	This world is just an insane asylum.	False
Tudod, hogy a templomban van?	Do you know she's in the church?	True
Azon dolgozom.	You clean up.	False
Egész éjszaka sírt.	I don't enjoy eating ice cream during the winter.	False
Számos csillag volt látható az égen.	Numerous stars were visible in the sky.	True
Üdvözölt bennünket.	Give me the knife.	False
Megjavította-e az új edző a csapat minőségét?	Has the new coach improved the team's quality?	True
Néhány ember lenéz másokat, csak mert kevesebb pénzük van.	Some people look down on others because they have less money.	True
Belém rúg!	This is silly!	False
Ezen a vidéken nincs elég víz.	Water is scarce in this area.	True
A nyelv tudomásunk szerint egy emberi találmány.	Language, as we know it, is a human invention.	True
A város szó szerint Mussolininek köszönheti a létét?	Does the city literally owe its existence to Mussolini?	True
Ez nem fontos.	This matter is very urgent.	False
Ha nem megy el az iskolába, nem beszélek vele többé.	If he doesn't go to school, I will not talk to him anymore.	True
A szomszédasszonyom kleptomániás.	My neighbor is a kleptomaniac.	True
Elvesztettem a jegygyűrűmet.	He begged us to go with him.	False
Az állatok nem tudnak különbséget tenni az igaz és hamis dolgok között.	They are too busy fighting against each other to care for common ideals.	False
Mire gondolsz, amikor a rádióaktivitás szót meghallod?	Are you intentionally trying to confuse me?	False
Na mozdulj már!	Get your arse into gear!	True
Mennyire fáj?	Are they in Paris?	False
Tom Jacksoné a ló, amelyik megnyerte a versenyt.	The horse that won the race is owned by Tom Jackson.	True
Ne tegyen úgy, mintha nem tudná, miről beszélek!	There is nothing to be scared of.	False
Én próbáltam.	I knew you could do it, Tom.	False
Itt van egy törülköző, ezt használhatod.	Here's a towel that you can use.	True
Meg akarod ezt ma csinálni?	Can your brother drive a car?	False
Egyre több pár megy külföldi nászútra.	More and more couples go on honeymoon trips abroad.	True
A legtöbb ember azt hiszi, hogy őrült vagyok.	No one is listening to you.	False
Várjunk csak, most mit is akarsz tenni?	Do you really want to break up with your girlfriend?	False
Művészetben megegyezik az ízlésünk.	Animals cannot distinguish between truth and falsehood.	False
A gazdaság stabilitása minden kormány célja.	A stable economy is the aim of every government.	True
Elengedné a karom?	I saw somebody steal the merchandise.	False
- Nagyon jó lehet magasnak lenni. - Úgy véled? Nem igazán olyan jó. Folyton bevered a fejed a plafonba.	"""It must be great to be tall."" ""Do you think so? It's not really that great. You keep bumping your head on the ceiling."""	True
Házas vagyok és van egy lányom.	I am married and I have a daughter.	True
Aláírták a szerződést.	The treaty was signed.	True
Ne legyél köcsög.	Don't forget to write the zip code.	False
Ha nagy leszek, pilóta leszek. És te mi leszel?	When I grow up, I'll be a pilot. And what will you be?	True
Az orvos megszegte a hippokratészi esküt.	The doctor broke the Hippocratic Oath.	True
A cég tankönyveket ad ki.	The firm publishes educational books.	True
Folytatta a munkát.	She proceeded with the work.	True
Ez nem az én esernyőm, hanem valaki másé.	This world is just an insane asylum.	False
Kezdjük veled.	You must stop him.	False
Jordan úr egy kicsit meglepett volt.	She's a cold-hearted bitch.	False
Együtt kell odamennünk.	I think we should wait another half an hour.	False
Tudom, hogy Tom a barátod.	Tom told me that I could use his computer.	False
Most menjünk moziba?	Can your brother drive a car?	False
Itt lesz nemsokára?	Could we go somewhere else?	False
Kato úrnő volt tavaly a tanárod?	Was Ms. Kato your teacher last year?	True
György születésétől fogva becsületes.	This fact must not be forgotten.	False
Ki kell találnunk valamit.	There is nothing to be scared of.	False
Bizonyára esni fog.	Love is never wasted.	False
Tud a fivéred autót vezetni?	Can your brother drive a car?	True
Nem értem a kérdés jelentését.	I don't understand the meaning of the question.	True
Te mit mondanál a helyemben?	May I leave a message?	False
A mopszok nem valami aranyosak.	They are looking at only the sunny side of the American economy.	False
Itt a tavasz. Napról-napra melegebb van.	Spring is here. It is getting warmer every day.	True
Tom nem engedte Marynek, hogy a többi gyerekkel játsszon.	Tom didn't let Mary play with the other children.	True
Először is mutatnék neked valamit.	There is nothing to be scared of.	False
Akarsz is valamit mondani?	Is there something I can do for you?	False
Csak a boldogság számít.	Love of money is the root of all evil.	False
Muszáj rám bíznod magad.	Your old grandma dances well.	False
Tominak nincsenek megtakarításai.	This noise is unbearable.	False
Mikor kezdődik?	When does it start?	True
Lázas vagy?	Are you drunk or something?	False
Tom adta kölcsön nekem azt a DVD-t.	Tom loaned me that DVD.	True
Izgatottan várom a Karácsonyt.	Give me the knife.	False
Az iskola felé tartott.	The engine started again.	False
Éppen egy hosszú levelet ír.	He is said to have a cold.	False
Senki sem hallgat meg téged.	No one is listening to you.	True
Mit szólnál egy csésze forró kávéhoz?	How about a cup of coffee?	False
Mondd meg az igazat!	You must do it.	False
Oda se neki, miket mond!	Did you make out what he said?	False
Kölcsönkérhetem ezt a CD-t?	May I borrow this CD?	True
Szeretném mindenkinek a figyelmét kérni.	There is nothing to be scared of.	False
Három üveg bort kellett volna vennünk.	We should've bought three bottles of wine.	True
Fordítsuk komolyra a szót!	Get your arse into gear!	False
Most a boltba megyek.	They are in the way.	False
Sokat olvasok.	I write every chance I get.	False
Tomi két lánnyal randevúzik egyidőben.	Tom and Mary are mad at John.	False
Tanítson meg dzsúdózni!	Get your butt over here!	False
Számítanak az első benyomások.	If you understand this one, then the others are nearly the same.	False
Kórházban kellene lenned.	You should be in a hospital.	True
Senki sem lakik ebben a házban.	Nobody lives in this house.	True
Bizonyítékokra van szükségem.	There is nothing to be scared of.	False
Ő már nincs itt.	He is no longer here.	True
Illatos a gyertya.	This egg smells bad.	False
Gondoskodni fogok a szüleimről, ha megöregednek.	There is nothing to be scared of.	False
Télen nem szívesen eszem fagyit.	There is nothing to be scared of.	False
Eldöntötte, hogy Amerikába megy.	She made up her mind to go to America.	True
Akarod, hogy tegyek néhány szál virágot a hajadba?	Would you fetch me a glass of water?	False
Idő kell.	You need to stop wasting time.	False
Közös a hazánk.	Life is a bitch.	False
Hálásnak kellene lenned.	Money cannot buy health, nor happiness.	False
Mary olyan kedves lány, hogy mindenki szereti.	Mary is so nice a girl that she is loved by everybody.	True
Tomnak azt kéne tennie, amit Mary mond.	Tom should do what Mary says.	True
Az állatok az erdőben élnek.	Animals inhabit the forest.	True
Tanuld meg irányítani, vagy az fog irányítani téged.	Learn to control it or it will control you.	True
Majd várok odakint.	They are in the way.	False
Nekem is tudsz venni egyet?	Can you give me a better price?	False
Németországba repülök majd.	I will fly to Germany.	True
Hirtelen kialudtak a fények.	They are looking at only the sunny side of the American economy.	False
Zenehallgatás a hobbim.	Life is a bitch.	False
A nyári szünidő után a gyerekeknek vissza kell menniük az iskolába.	After the summer holidays, the children have to go back to school.	True
Olyan mérges volt, hogy nem tudott beszélni.	He could not speak, he was so angry.	True
Edzenem kell.	Tom tricked us again.	False
A mobilom leesett a földre.	The snowball melted in my hand.	False
A felesége álomszép, a lányát meg már ne is említsem.	His wife is as beautiful as a dream, not to mention his daughter.	True
Nem hoztam magammal meleg ruhát.	I meet Mihaela every morning at the subway.	False
Tedd fel a fejhallgatót!	Give me the knife.	False
Szükségünk van a válaszra.	Is it obligatory to rent a car?	False
Ez a könyv unalmas.	This book is boring.	True
Taro két éve meghalt.	Taro died two years ago.	True
Nehezére esik apámnak abbahagyni az ivást.	There is nothing to be scared of.	False
Egy étteremben ebédeltünk.	I saw somebody steal the merchandise.	False
Ez azért van, mert nem akarsz egyedül lenni.	This is because you do not want to be alone.	True
A motor megint beindult.	The engine started again.	True
Három kutya követ négy macskát a kerítésig.	Three dogs are following four cats to the gate.	True
Két fiam van. Az egyik Nara, a másik Tsu.	I have two sons. One is in Nara and the other in Tsu.	True
Beszélhetnénk erről később?	Could we talk about this later?	True
Szavazással döntünk.	I scratched my records.	False
Semmi más nem kell..., csak egy új nadrág.	I don't need anything... just a new pair of pants.	True
A szemétláda ellopta a hátizsákom, megette a szendvicsem és beleszart a termoszomba.	The doctor has taken a swab from the mucous membrane.	False
Tomi aláírta az iratot.	Tom signed the document.	True
Nagyon hideg van ebben a szobában, igaz?	There is a big hole in your stocking.	False
A Sinano hosszabb, mint bármely más Japán folyó.	The Shinano is longer than any other river in Japan.	True
A pénz minden rossz gyökere.	Love of money is the root of all evil.	False
Gyuri bácsi nem jött hozzánk soha üres kézzel látogatóba.	Uncle George never visited us without some present.	True
Már bekövetkezett.	This isn't going to end well.	False
Fel fog robbanni.	It's going to explode.	True
Az eszperantó egy tervezett, nemzetközi nyelv.	Esperanto is an international planned language.	True
Atatürk 1881-ben született Szalonikiben.	Atatürk was born in 1881, Thessaloniki	True
Nem akart megbántani.	I can't put up with his insults any longer.	False
Az a gyerek mindig mosolyog.	It'll be forgotten in a few months' time.	False
A fiam mindig nagyon független volt.	My son has always been very independent.	True
Érdekelnek a virágok?	Are you interested in flowers?	True
Akarod, hogy hívjak egy taxit?	Can your brother drive a car?	False
Nagy veszteségnél jobb a kis nyereség.	Better a small gain than a great loss.	True
Tomnak nincs láza.	She trusts him with her life.	False
Miért kérdezed?	Did you get anything from them?	False
Szóról szóra fordította le.	She translated it word for word.	True
Tom nem riad vissza semmilyen harctól, teljesen mindegy, kivel áll szemben.	Tom won't back down from any fight, no matter who he's up against.	True
Nem érdekel, hogy ki korán kel, aranyat lel, én aludni akarok.	If the world weren't in the shape it is now, I could trust anyone.	False
Sem az eszperantó, sem az interlingua nem alkalmaz kettős tagadást.	Neither Esperanto nor Interlingua employ double negative.	True
A gépi fordítás nem megbízható.	This noise is unbearable.	False
Úgy tűnik, hogy ez a marhaszelet véres. Kíváncsi vagyok, elég sokáig sütötték-e.	"""It must be great to be tall."" ""Do you think so? It's not really that great. You keep bumping your head on the ceiling."""	False
Tom mindig panaszkodik, hogy nincs elég szabad ideje.	Tom is always complaining that he doesn't have enough free time.	True
Tom a huszadik születésnapját ünnepelte a múlt héten.	Tom celebrated his twentieth birthday last week.	True
Büszkének kellene lenned.	She's a cold-hearted bitch.	False
Nem tudtad, hogy Tom homoszexuális?	You didn't know Tom was gay?	True
Nem dolgoztatod meg a tested eléggé.	You must do it.	False
Az érdekeink ütköznek az övékkel.	They are in the way.	False
Kaptál tőlük bármit is?	Did you get anything from them?	True
Szomorúan mosolyogva beszéli kezdett.	She made up her mind to go to America.	False
Hol van a szennyes?	Who is sick?	False
Ma este későn kell vacsoráznunk a találkozó miatt.	They were hung up in a traffic jam for half an hour.	False
Tökéletesre fejlesztette a nehéz esetű vevőkkel való bánásmódot.	Sexual harassment can be a serious problem in the workplace.	False
Isten ments, hogy Tommal történjen valami!	It's going to explode.	False
Ez nagy hiba volt.	This was a big mistake.	True
Tomi gazdagabb Marinál.	Tom is richer than Mary.	True
A hajó tegnap áthaladt az egyenlítőn.	That ship crossed the equator yesterday.	True
Japánból jött.	She is from Japan.	True
Tom most egy könyvet ír.	Tom is writing a book.	True
A személyiség és vértípus közti kapcsolat tudományosan nem bizonyított.	A connection between personality and blood type has not been scientifically proven.	True
Szeretnéd tudni, hogy csináltam?	How long did it take you to write this book?	False
Pihentünk egy kicsit.	There is a big hole in your stocking.	False
Nem örült neki Tom.	No one is listening to you.	False
Ne mondd ki ezt a szót.	Don't forget to write the zip code.	False
Inkább tartanék macskát, mint kutyát.	I would rather have a cat than a dog.	True
Tom megvakartatta Marival a hátának azt a részét, amelyet nem ért el.	Tom got Mary to scratch the part of his back he couldn't reach.	True
Tom a délutánt Maryvel töltötte.	Tom spent the afternoon with Mary.	True
Részeg vagy vagy mi?	Which country are you from?	False
Tom azt mondta, hogy használhatom a számítógépét.	Tom told me that I could use his computer.	True
A nyelvem hegyén van a szó.	The word is on the tip of my tongue.	True
Az életét bízná rá.	She trusts him with her life.	True
Éhesek.	They are hungry.	True
Tom csak horgászni akar.	Peter is buying a tomcat.	False
Olyan képet vág, hogy legszívesebben bemosnál neki egyet.	Mary is so nice a girl that she is loved by everybody.	False
Ezt hosszú csend követte.	She kept crying all night long.	False
Az emberek saját földet akarnak.	People want to own land.	True
Néha különös fiúnak látszik.	He has too many books.	False
Sztár vagy.	Tom tricked us again.	False
Tudok gitározni.	I can play the guitar.	True
Az inge szürke, a nyakkendője sárga volt.	His shirt was gray and the tie was yellow.	True
Meg kell nézned ezt a filmet.	You have to see this movie.	True
Ördögien jól táncol az idős nagymamád!	Your old grandma dances well.	True
Nem tudom, hogy miért csináltam ezt.	I didn't know where it came from.	False
Pont most történt egy baleset.	I have worked for one company where the payroll was snatched on a dark winter's night.	False
Tomi nem néz háborús filmeket.	Tom doesn't watch war movies.	True
A következő kereszteződésnél jobbra!	This is the last train.	False
Elmész Tomival?	How about a smoke?	False
Tamás nem ismer téged.	I know that John is honest.	False
Egész nap teniszeztem.	I played tennis all day.	True
Ha nagy leszek, király akarok lenni.	When I grow up, I want to be a king.	True
Várj egy kicsit!	Son of a bitch!	False
Rossz a leheleted.	He bade us welcome.	False
Mennyit keres havonta?	Can your brother drive a car?	False
Ez nagy összeg.	Better a small gain than a great loss.	False
Tomi aláírta a papírokat.	Tom signed the document.	False
Bár a Föld felületének csupán két százalékát borítják őserdők, ott él a világon fellelhető állat-, növény- és rovarfaj fele.	Although rainforests make up only two percent of the earth's surface, over half the world's wild plant, animal and insect species live there.	True
Szeretem a leveseket sok zöldséggel.	There is a big hole in your stocking.	False
El kellett neki mondania.	He begged us to go with him.	False
Sírsz?	Is Laurie at home?	False
Menekülnöd kell.	Don't step on the broken glass.	False
Engem senki sem szeret.	No one is listening to you.	False
Klabaster és Gizmo macskák.	Klabaster and Gizmo are cats.	True
Abba kell hagyni az időpocsékolást.	You need to stop wasting time.	True
Ne bámulj engem.	Teach judo to me.	False
Te hiszel a szellemekben?	Why are you under the desk?	False
Úgy gondolom, meg tudom csinálni.	To tell the truth, I've already seen that movie.	False
Ez komoly?	Is it serious?	True
Ezt a mondatot körülbelül egy órával ezelőtt az utcán hallottam.	I heard this sentence on the street about an hour ago.	True
Mérgesen lépett fel vele szemben.	I was humiliated in public.	False
Szörnyen fontos.	It's terribly important.	True
Bejött Tom.	Tom tricked us again.	False
Valaki ellopta az utazási csekkjeimet.	Tom squandered his entire inheritance.	False
A repülőtér egy karnyújtásnyira található.	The airport is close at hand.	True
Van egy nagy lyuk a zoknidon.	There is a big hole in your stocking.	True
Át fog költözni Új-Zélandba.	She will be relocated to New Zealand.	True
Nem volt víz a kútban.	There was no water in the well.	True
Ez a téma rendkívül ellentmondásos.	It is unfortunately true.	False
Ha mérges vagy, számolj tízig, ha nagyon mérges vagy, százig.	When angry, count ten; when very angry, a hundred.	True
Azt javasoltam, hogy azonnal kezdjünk hozzá.	I suggested that we should start at once.	True
Nem szidhatlak. Az én hibám volt.	I kept my word.	False
Csendesedett a szél.	The noise gets on my nerves.	False
Vissza kell menned.	You can do it from the outside.	False
Ne gyere későn, oké?	Don't come late, okay?	True
Autóval mentek az állomásra.	They went to the station by car.	True
Tom megváltoztatta a véleményét?	Tom said he thought he knew what the problem was.	False
Másik államban él.	He lives in another state.	True
Tom azt mondja, soha többé nem megy el.	Now that Mary has left, Tom is happier.	False
Egy spanyol emberrel dolgozom.	I'm working with a Spaniard.	True
Clinton akkoriban Arkansas kormányzója volt.	Mr. Clinton was governor of Arkansas at the time.	True
Az éjszakába nyúlóan vitatkoztunk a dologról.	They are looking at only the sunny side of the American economy.	False
El tudod hinni, hogy Tom még csak tizenhárom?	Can you believe Tom is still only thirteen?	True
Túl sokat iszol.	You have foul breath.	False
Tom nem akart válaszolni a kérdésre.	Tom didn't want to answer the question.	True
Amikor kinyitotta az ajtót, azonnal érezte, hogy ég valami.	When Tom finally decided to come out of the closet, everyone already knew he was gay.	False
Hamlet talán nem akart megházasodni. Akárhogy is, Hamlet csak egy volt, de sok ember megegyezik ebben vele.	Hamlet probably didn't want to get married. There was only one Hamlet, however there are many people like him.	True
Elővigyázatosnak kell lenned.	To be perfect she lacked just one defect.	False
Ami engem illet, nincs semmi hozzáfűznivalóm.	There is nothing to be scared of.	False
Gyere már, dolgunk van.	You are drunk!	False
Ideülhetek?	Did I miss something?	False
A rózsák jó illatúak.	She likes oranges.	False
Sok a könyv.	Life is a bitch.	False
Legyen szíves, itt írja alá.	Here's a towel that you can use.	False
Az emberi agy körülbelül három fontot nyom.	The human brain weighs about three pounds.	True
Azt hiszem orvoshoz kellene menned.	He begged us to go with him.	False
Hogy tetszett?	Who told him that?	False
Elszégyellte magát amiatt, amit látott.	He felt ashamed about what he saw.	True
Attól tartok, ez az igazság.	I fear that is the truth.	True
A doktornő mintát vett a nyálkahártyából.	The doctor has taken a swab from the mucous membrane.	True
A 23-as jobban áll rajtad.	The 23 fits you better.	True
Ez van, ezt kell szeretni.	I got over it. You should, too.	False
Néhény embert nem kellene a kormányhoz engedni.	Some people shouldn't be allowed to drive.	True
Mari leborotválta a lábát.	Tom got Mary to scratch the part of his back he couldn't reach.	False
Rémálmom volt.	Tom was mad.	False
Kölcsönadtál egy könyvet.	Tom is writing a book.	False
Kimehetek játszani?	May I go out to play?	True
A macskák nem szeretnek vizesek lenni.	They are hungry.	False
Maryt elrabolták a kalózok.	She allegedly killed him.	False
Őszintén remélem, hogy hamar meggyógyul.	There is nothing to be scared of.	False
Mosás közben egy óvszert talált a fia farzsebében.	While doing the wash she found a condom in the back pocket of her son's pants.	True
Hála istennek, ateista vagyok.	Thank God I am an atheist.	True
A parkban tömeg volt.	There were a crowd of people in the park.	True
Ki beteg?	Who is sick?	True
Ő egy igazi kurva.	He is a man of weak character.	False
Aki nem ismer idegen nyelveket, semmit sem tud a sajátjáról.	Anyone who doesn't know foreign languages knows nothing of his own.	True
A gyerekek imádnak a homokban ásni.	Animals inhabit the forest.	False
Nagy fiú vagy, viselkedj!	Now you are a big boy, behave yourself.	True
Jól érzem magam a saját bőrömben.	I feel good in my own skin.	True
Sok ember van a parkban.	There are a lot of people in the park.	True
Lementem a lifttel.	You lent a book.	False
"Ne tekints rám többé úgy, mint egy ""normális"" személyre!"	There is nothing to be scared of.	False
Útját kell állnod.	You must stop him.	True
Azt mondtam nekik, hogy rendben vagyok.	This is also part of your work, as I told you before.	False
Később ma még ő is visszautazik.	He is also returning late today.	True
Kérlek, ne keress!	Please, give me your address.	False
Köszönöm, hogy segítettél.	To tell the truth, I've already seen that movie.	False
És mégis, az ellenkezője is mindig igaz.	And yet, the contrary is always true as well.	True
Mindenki elszótlanodott.	Everyone was speechless.	True
Az az érzésem, senki sem foglalkozik olyan sokat a hangsúlyozással, mint az oroszok.	I've got a feeling that nobody cares about their accent as much as the Russians.	True
Találkoztunk mi már?	Have we met?	True
Nem tudtam, honnan jött.	I knew you could do it, Tom.	False
Nem emelte fel a kezét.	He did not put up his hand.	True
Pihennie kellett.	Everyone was speechless.	False
Megkértem, hogy randizzon velem, de nemet mondott.	He begged us to go with him.	False
Tomnak soha többé nem kell Mary miatt aggódnia.	He is madly jealous of his woman.	False
Nincs rá időm, hogy segítsek neked a munkádban.	There is nothing to be scared of.	False
Hol tudunk parkolni?	What are you going to use this car for?	False
Nem alszom ágyban.	I kept my word.	False
Már megint itt van a karácsony?	Where is the laundry?	False
Tom egy csónakban lakik.	Peter is buying a tomcat.	False
Szándékosan megpróbálsz összezavarni?	Are you intentionally trying to confuse me?	True
Vírussal fertőzött a számítógéped.	Your computer is infected with a virus.	True
Olyan türelmetlen vagy velem.	I saw somebody steal the merchandise.	False
Betti szereti a klasszikus zenét.	Betty likes classical music.	True
A kérésedet elutasították.	The photograph was falsified.	False
Örülök, hogy találkoztunk.	We know each other quite well.	False
Az autó lerobbant, úgyhogy gyalogolnunk kellett.	The car broke down, so that we had to walk.	True
Megteszem, ha megfizetik.	You must stop him.	False
A sikere részben a szerencsének köszönhető.	His success was due in part to good luck.	True
Megadom neked a honlaphoz a linket.	I'll give you the link to the website.	True
Én vagyok a legjobb.	I'm the best.	True
Ha a világ nem olyan lenne, mint most, akkor mindenkiben bízhatnék.	If the world weren't in the shape it is now, I could trust anyone.	True
Tamás valahol errefelé lakik.	Tom went outside.	False
Hoznál nekem egy pohár vizet?	Would you fetch me a glass of water?	True
Ez a kedvenc kifejezésem.	It's terribly important.	False
A fiú a barátaival úszik.	The boy is swimming with his friends.	True
Nevettek és sírtak egyszerre.	They laughed and cried at the same time.	True
A képen két férfi és egy nő áll egy fa mellett.	There are two men and a woman standing next to a tree in the picture.	True
Mindig mosolyog.	I study about two hours every day.	False
Volt egyszer egy szegény ember és egy gazdag asszony.	Once upon a time, there lived a poor man and a rich woman.	True
Részemről nincs kifogás.	The photograph was falsified.	False
Úgy tűnik, mindjárt elered az eső.	It's going to explode.	False
Tamás folyton tanul.	Tom studies all the time.	True
Te takarítod fel.	The 23 fits you better.	False
Az üzletünk nincs nyitva.	He is no longer here.	False
Amikor végre úgy döntött Tom, hogy beismeri homoszexualitását, már mindenki tudta.	When Tom finally decided to come out of the closet, everyone already knew he was gay.	True
Tényleg szakítani akarsz a barátnőddel?	Do you really want to break up with your girlfriend?	True
Őrülten féltékeny a feleségére.	He is madly jealous of his woman.	True
- Apa, miért kék az ég? - Hát mert az!	"""Daddy, why is the sky blue?"" ""Well, it just is."""	True
A kapitány megparancsolta az embereinek, hogy tüzeljenek.	The captain ordered his men to fire.	True
Mondta Tom, hogy tudni vélte, mi a probléma.	Tom said he thought he knew what the problem was.	True
A vállamon aludt el.	She had to stand in the train.	False
Ki volt ma itt az első?	Who was the first one here today?	True
Ez a lárma elviselhetetlen.	Nobody is indispensable.	False
Gyakran repülsz?	You should ignore what he says.	False
Házas vagyok, és van két gyerekem.	I am married and I have a daughter.	False
Ez sokat segítene.	There is nothing to be scared of.	False
Nem vagy álmos?	Who is sick?	False
Noha nem én nyertem, de azért sikerült kapnom egy vigaszdíjat.	I didn't win, but at least I got a consolation prize.	True
A rendőr a szokásos éjszakai őrjáratán volt.	The policeman was on his usual nightly round.	True
Amikor kicsi voltam, szerettem volna háziállatnak egy barnamedvét, hogy megijessze a szomszédokat.	When I was little, I wanted to have a pet brown bear to scare my neighbors.	True
Tomi radikális.	Tom is radical.	True
Mit szólna egy csésze teához?	Can your brother drive a car?	False
Gyerekek játszanak a parton.	Several children are playing on the beach.	True
Jártál valaha külföldön?	Are they in Paris?	False
A vonatban állnia kellett.	She had to stand in the train.	True
Abba kell hagynod a piálást.	Don't forget to write the zip code.	False
A macska a lábtörlőn van	The cat is on the mat.	True
Kettejük közül ő a szorgalmasabb.	He is the more diligent of the two.	True
Eljönnél velem a folyóhoz?	Won't you go with me to the river?	True
Róma sem egy nap alatt épült fel.	Rome was not built in a day.	True
Akkora vagy!	Today is a big day, son!	False
Az infláció csökken.	Excessive supply leads to a drop in prices.	False
Van egy iskola a házam közelében.	There is a school near my house.	True
Érdemes megnézni a várat.	The castle is worth visiting.	True
Nagyon gyorsan tudok írni.	I like skiing very much.	False
Ő és én hasonlóan gondolkodunk.	We know each other quite well.	False
Ágyban kéne maradnia három vagy négy napig.	You should stay in bed for three or four days.	True
Ajándékot keresek az édesanyámnak.	She trusts him with her life.	False
Ez az én válaszom!	Give me that piece of paper, and I will inspect it!	False
Lenne az ellen kifogásod, ha segítenék?	May I leave a message?	False
Te értetted, mit mondott?	Who told him that?	False
Egy férfi nem sír nyilvánosság előtt.	The photograph was falsified.	False
Van söröm.	I will shoot him.	False
Nagyon dögös vagy.	It's a large amount.	False
Tudna nekem egy jobb árat mondani?	Can you give me a better price?	True
Azért, mert lány vagy.	I got over it. You should, too.	False
Tomit fel kell tartóztatni.	Tom needs to be stopped.	True
Kevésbé türelmes, mint a bátyja.	He is less patient than his brother.	True
Az épület húszemeletes.	The building has twenty floors.	True
Úgy hallottam, hogy bébiszittert keresel.	It occurred to me that the man was trying to cheat me out of my money.	False
Csupán tíz százalékát használjuk az agyunknak.	We only use 10% of our brain.	True
Nekem ez elég.	It's terribly important.	False
Elhitette velem azt, hogy nem hallott engem.	He begged us to go with him.	False
Felkapcsolták a világítást.	You need to stop wasting time.	False
Te hülye!	Get your arse into gear!	False
Külföldi vagyok.	I am a foreigner.	True
A tanárunk egy gentlemen, a szó igazi értelmében.	Our teacher is a gentleman in the true sense of the word.	True
Általában sosem vagyok otthon, amikor a füvet nyírják, ezért csak a lenyírt gyepet látom.	I wasn't usually home when the lawn was cut, so all I ever saw were the results.	True
Csak nem szarkazmust hallok ki a szavaidból?	Are you intentionally trying to confuse me?	False
Két szemem van.	I have two eyes.	True
Iskolánk a város központjában található.	Our school is in the center of the town.	True
Az egy magas épület, ugye?	Who is sick?	False
Kérjük, adja meg a nevét és a címét ezen az űrlapon!	Give me that piece of paper, and I will inspect it!	False
Láttam, hogy valaki ellopta az árut.	To tell the truth, I've already seen that movie.	False
Tom egész nap dolgozott tegnap.	Tom spent all day looking for a job.	False
Arthur kora ötvenes éveiben járt.	Arthur was in his early fifties.	True
Szednünk kell a lábunkat.	Give me the knife.	False
Meg tudsz őrizni egy titkot?	Can you keep a secret?	True
Ön nem volt ott? - kérdezte Jordan úr.	"""Weren't you there?"" asked Mr Jordan."	True
Részletes utasításokat adtam neki.	I gave him detailed instructions.	True
Szeretsz utazni?	Will you go with Tom?	False
A kanapé alatt van a tv-távirányító.	There is a TV remote control under the couch.	True
Ezt a tényt nem szabad elfelejteni.	This fact must not be forgotten.	True
Szeretném tudni, ki kezdte ezt.	I want to know who started this.	True
Siess!	This is silly!	False
Tom kinyitotta az ajtót, mielőtt még Maria kopogni tudott volna.	Tom opened the door before Mary had a chance to knock.	True
Téged meglőttek, Tom.	You got shot, Tom.	True
Kivel mentél szörfözni?	Who did you go surfing with?	True
Attól tartok, nem jön el.	Stop staring at me.	False
Azt akarja, hogy barátok legyenek csak.	She wants him to be just a friend.	True
Péter egy kandúrt vásárol.	Peter is buying a tomcat.	True
Mari fodrász.	Tom is radical.	False
Az a hír kapott szárnyra, hogy kirúgták.	It occurred to me that the man was trying to cheat me out of my money.	False
Csak kérdezem magamban, hogy ez mindenki másnak ugyanaz-e.	I can only wonder if this is the same for everyone else.	True
Ez képen jobban néz ki, mint a valóságban.	That looks better in the picture than in reality.	True
Senki nem szerzett elég szavazatot ahhoz, hogy megnyerje a szavazást.	No man received enough votes to win the nomination.	True
Jó leszek.	I will shoot him.	False
Moziba mész?	How about a smoke?	False
Ő nem beszél sokat.	No one is listening to you.	False
Aláírtam a szerződést.	I signed the contract.	True
Meddig kell várnom?	Did I miss something?	False
Elmehetünk máshová?	Could we go somewhere else?	True
Azért jött, hogy megkérjen minket, hogy segítsünk neki.	He begged us to go with him.	False
Milyen volt a franciaóra?	How was the French class?	True
Nagyon meg kéne javítani a tetőt.	The roof is really in need of repair.	True
Tom rákényszerült, hogy eladja a gazdaságát.	Tom was forced to sell his farm.	True
Menjünk, igyunk meg egy kávét.	Give me that piece of paper, and I will inspect it!	False
A nők általában 10 évvel tovább élnek mint a férfiak.	Women usually live 10 years longer than men do.	True
Tom elhatározta, hogy megpróbál tabletta nélkül aludni.	When Tom finally decided to come out of the closet, everyone already knew he was gay.	False
Az ember nem olyan mindenható, mint Isten.	Man is not as almighty as God.	True
Tomi haja hátra van fésülve.	Now that Mary has left, Tom is happier.	False
Kívülről meg tudod tenni.	There is nothing to be scared of.	False
Ez számomra volapük.	This is silly!	False
Körülbelül 133 kilométerre van Londontól.	It's about 133 kilometers from London.	True
Ne hajtson annyira a bosszú!	Give me the knife.	False
A nevem Jack.	My name is Jack.	True
Zamenhof, a tervezett eszperantó nyelv kezdeményezője, szemorvos volt.	Zamenhof, creator of the constructed language Esperanto, was an ophthalmologist.	True
Vidd haza!	This is silly!	False
Gyengéden a vállára tette a kezét.	He could not speak, he was so angry.	False
Tomi aláírt egy beleegyezési nyilatkozatot.	She gave me a conflicting answer.	False
Minden könyvtári könyvet vissza kell vinni év végéig.	You should return all the library books before the end of the year.	True
A Nap egy közepes csillag.	The sun is a medium-sized star.	True
Jól beszélsz kínaiul?	Do you speak Chinese well?	True
Az igazat megvallva, én már láttam ezt a filmet.	To tell the truth, I've already seen that movie.	True
Tomi felbontott egy sört.	Peter is buying a tomcat.	False
Senki sem pótolhatatlan.	There is nothing to be scared of.	False
Rózsákat ültettem a kertbe.	I planted roses in the garden.	True
Biztos, hogy ő egy kedves ember, de nem nagyon okos.	He is a nice person, to be sure, but not very clever.	True
Kell valami étel.	You have foul breath.	False
Szedd össze a játékaidat!	Get your arse into gear!	False
Elpusztította az ellenségeit.	He exterminated his enemies.	True
Add oda azt a darab papírt, majd én megvizsgálom.	Give me that piece of paper, and I will inspect it!	True
Biztos vagyok benne, hogy korán elmegy.	There is nothing to be scared of.	False
A földeken dolgozik.	Animals inhabit the forest.	False
Amit Tomi mondott, annak semmi értelme.	Tom won't believe a word you tell him.	False
Szeret Ön táncolni?	May I go out to play?	False
Értékelem a segítségedet és a barátságodat.	I value your help and friendship.	True
Én tudom, hogy úgy történt.	I thought I was doing the right thing.	False
Ne közelíts a barátnőmhöz!	No one is listening to you.	False
A lámpa szürke.	The lamp is grey.	True
Helyesled azt, amit csinál?	Is there something I can do for you?	False
Mária kellett Tominak.	Tom needed Mary.	True
Járnak iskolába a gyerekek?	Do the children go to school?	True
Nyelvtan szempontjából rendben van, de egy anyanyelvű nem mondana ilyet.	Anyone who doesn't know foreign languages knows nothing of his own.	False
A matematika óra jó.	Life is a bitch.	False
Elnökként beiktatták őt.	He was inaugurated as President.	True
Beszéltem Tomival telefonon.	I spoke to Tom on the phone.	True
- Nem - ismételte az angol.	I can't speak Turkish.	False
Jakab nagyon szigorú a gyermekeivel.	He is madly jealous of his woman.	False
Kórházba kellene menned.	He begged us to go with him.	False
Talán segítséget kellene szereznünk.	There is nothing to be scared of.	False
Vettünk egy nagy zongorát, ami a fél nappalit elfoglalta.	I have worked for one company where the payroll was snatched on a dark winter's night.	False
A macskák látnak a sötétben?	Do cats see in the dark?	True
Ha ilyen lehetnék...	Then there is a problem...	False
Ő a tökéletes pasi.	Life is a bitch.	False
A nővérem minden reggel hajat mos.	I meet Mihaela every morning at the subway.	False
A véletlen egy síközpontban hozott össze bennünket.	This world is just an insane asylum.	False
Ez nagyon furcsa.	This was a big mistake.	False
"Mivel a kommunizmus összeomlott, mostanában a kapitalizmust vádolják azzal, hogy ""világuralomra tör""."	"As communism has collapsed, capitalism is now accused of trying to ""dominate the world."""	True
Néhány hónapon belül feledésbe fog merülni.	It'll be forgotten in a few months' time.	True
Többé nem tudok belenyugodni a sértéseibe.	He is madly jealous of his woman.	False
Kiment Tomi.	Tom tricked us again.	False
A szobám ki lett takarítva.	The photograph was falsified.	False
Valami miatt mindig panaszkodik.	He is madly jealous of his woman.	False
Köszönöm, hogy önként jelentkeztél.	To tell the truth, I've already seen that movie.	False
Jól aludtál?	May I go out to play?	False
Nem emlékszem rá, hogy raktam-e már bele sót.	Would you fetch me a glass of water?	False
Tamás eltékozolta az egész örökségét.	Tom squandered his entire inheritance.	True
Holnap Kumamotoba megyek, hogy lássam Aoi urat.	I will go to Kumamoto to see Mr Aoi tomorrow.	True
Nagyon meleg volt.	She had a little money.	False
Megyek, megetetem a kacsákat.	I'm going to go feed the ducks.	True
A lányok aludtak.	The girls were asleep.	True
Azt mondta nekem, hogy valaha gazdag ember volt.	He told me how he had once been a rich man.	True
Kiadó házat keresek.	They earn their living by collecting and selling old newspapers.	False
A jobb zoknid kifordítva vetted fel.	You have your right sock on wrong side out.	True
Tom elsétált az étteremből.	Tom walked away from the restaurant.	True
Nem tudom abbahagyni a nevetést.	I can't put up with his insults any longer.	False
Bolond vagy?	Are you drunk or something?	False
Azt akarom, hogy letartóztassák Tomot.	"""That bitch kicked me in the balls."" ""You deserved it."""	False
A fejlett országoknak segíteniük kell a fejlődő országokon.	Advanced countries must give aid to developing countries.	True
Ez kellett Tominak.	Tom needed this.	True
Tegnap elmentem a háza előtt.	I meet Mihaela every morning at the subway.	False
Most túlságosan elfoglalt vagyok ahhoz, hogy beszéljünk.	There is nothing to be scared of.	False
Miért akarod elkérni a kocsimat?	Can your brother drive a car?	False
- Az a köcsög tökön rúgott.- Megérdemelted.	The snowball melted in my hand.	False
Kurva anyád!	Hurry it up!	False
Segített a barátainak.	We are compatriots.	False
Ez az igazgató érzékeny a kritikára.	This director is not insensitive to criticism.	True
Az ebéd délben van.	This is irrelevant.	False
Hogyan tudjuk bebizonyítani, hogy ez valóban megtörtént?	How can we prove it actually happened?	True
Mindig panaszkodik, hogy milyen kicsi a szobája.	Mary is so nice a girl that she is loved by everybody.	False
Baszd meg anyád, köcsög.	Son of a bitch stole my backpack, ate my sandwich, and shit in my Thermos!	False
Úgy viselkedett, mint egy gyerek.	He behaved like a child.	True
Nem szánalmas, hanem közkedvelt akarok lenni!!	There is nothing to be scared of.	False
Néhány szomszéd nagyon hangos.	Some neighbors are very noisy.	True
Vannak itt emberek, akiknek szükségük van a segítségedre.	They are too busy fighting against each other to care for common ideals.	False
Az eszperantóban a hangsúly mindig az utolsó előtti szótagra esik.	In Esperanto, the main stress always falls on the second-to-last syllable.	True
Zamenhof, a tervezett eszperantó nyelv megalkotója, szemorvos volt.	Zamenhof, the creator of Esperanto, was an ophthalmologist.	True
Ő egy gyenge akaratú ember.	He is a man of weak character.	True
Senki nem tudja a választ.	No one has the answer.	True
Valami nyilvánvalóan rossz.	It is unfortunately true.	False
Nem értem ezt a verset.	I didn't win, but at least I got a consolation prize.	False
Ha ezt érted, a többi majdnem ugyanaz.	If you understand this one, then the others are nearly the same.	True
Én tudom, milyen az, valakit elveszíteni.	If the world weren't in the shape it is now, I could trust anyone.	False
Párizsban vannak?	Are they in Paris?	True
Háromszor hánytam.	I threw up three times.	True
Követtél?	Did I miss something?	False
Miért mentél Japánba?	Why'd you go to Japan?	True
Most, hogy Mary elment, Tom boldogabb.	Now that Mary has left, Tom is happier.	True
Nem tartozik rád.	They live nearby.	False
Aki keres, az talál.	"""That bitch kicked me in the balls."" ""You deserved it."""	False
A halál végleges.	The photograph was falsified.	False
Épp most láttam őket.	I saw somebody steal the merchandise.	False
Ez a hajó elment.	That ship crossed the equator yesterday.	False
Sohasem kedveltem a biológiát.	I once wanted to be an astrophysicist.	False
Tom hamarosan házasodik.	Tom is getting married.	True
Lehet, hogy holnap esni fog.	It's going to explode.	False
Nélküled is boldogulnánk.	He bade us welcome.	False
Épp elkezdtem volna írni egy levelet, mikor hazaért.	I was just going to write a letter when he came home.	True
Minden út Helsingörbe vezet.	All roads lead to Elsinore.	True
Általában ötkor megyek haza.	I usually go home at five.	True
Nagyon kedvel téged.	The 23 fits you better.	False
Elmentem megnézni a szüleimet.	There is nothing to be scared of.	False
Lent leszek, ha szükséged van rám.	Give me that piece of paper, and I will inspect it!	False
György nem veszi komolyan a tanulást.	There is nothing to be scared of.	False
Egyedül fogok beszélni vele.	Just ignore Tom. He always seems to be complaining about something.	False
Becsuknád az ajtót?	Damn! I can't find my wallet.	False
Tomi bútorokat gyárt.	The firm publishes educational books.	False
Nem volt elégedett Tom.	Tom wasn't pleased.	False
Számítok rátok, hogy csatlakoztok hozzánk.	I am counting on you to join us.	True
Minden reggel találkozom Michaelával a metrón.	I meet Mihaela every morning at the subway.	True
Segíteni fogok neked a takarításban.	I have no time to help you with the work.	False
Hagyhatnék egy üzenetet?	May I leave a message?	True
Nem akarom azt, hogy félj tőlem.	He begged us to go with him.	False
Jefferson, amerikai elnök, kereskedelmi tilalmat rendelt el Európával.	President Jefferson ordered a ban on trade with Europe.	True
Sikerük nagyban összefügg a szorgalmukkal.	Fear of communism was very strong at that time.	False
Miért sietsz ennyire?	Do you want to drink something?	False
Inna valamit?	Did I miss something?	False
Nem jött válasz.	I had no chance to escape.	False
Igazán nem hittem volna, hogy ez megtörténik.	I knew it would happen this way.	False
Jó vagyok hozzád ma reggel.	Today is a big day, son!	False
A baseball messze a legnépszerűbb sport Japánban.	Baseball is by far the most popular sport in Japan.	True
Ő engem nem érdekel.	There is nothing to be scared of.	False
Biztosan ön Tamás édesapja.	He has two beautiful boys.	False
György szegény, mégis mindig boldog.	George is poor, but he's always happy.	True
Valami nem volt kóser.	Something wasn't kosher.	True
Ezek történnek.	It's going to explode.	False
Micsoda cirkusz!	You are drunk!	False
Ő egy kőszívű ribanc.	He is a man of weak character.	False
Nem volt más választása, mint belenyugodni a sorsába.	There is nothing to be scared of.	False
Továbbment Tomi.	Tom needed this.	False
Az önsajnálat nem segít.	This noise is unbearable.	False
Elmennél végre?	May I leave a message?	False
Mert én értek kínaiul.	Because I speak Chinese.	True
A szó elszáll, az írás megmarad.	In Esperanto, the main stress always falls on the second-to-last syllable.	False
Valószínűleg ismét neked van igazad.	To tell the truth, I've already seen that movie.	False
Találtam lakóhelyet.	I found a place to live.	True
Illik hozzád a kék.	Give me the knife.	False
Mondtad, hogy Mary szép, de nem gondoltam, hogy ennyire.	You said Mary was beautiful, but I didn't think she would be this beautiful.	True
Rögtön visszajövök.	I saw somebody steal the merchandise.	False
Mit szólnál egy csésze kávéhoz?	How about a cup of coffee?	True
Feltételezem, hogy ez a dolog másnak tűnik, ha sokáig gondolkodol rajta.	There is nothing to be scared of.	False
1917-ben Európa háborúban állt.	In 1917, Europe was at war.	True
Kicsit halkabban, kérem!	This is silly!	False
Az utat az azt övező szikláról leeső kövek zárták el.	Although rainforests make up only two percent of the earth's surface, over half the world's wild plant, animal and insect species live there.	False
Ehhez senkinek nincs joga.	You must deny it.	False
Édes volt.	I am married and have two children.	False
Ön tudni fogja, hogy mit tegyen.	There is nothing to be scared of.	False
A jogosítványomat használtam, hogy igazoljam magam.	Tom told me that I could use his computer.	False
Tom nagyon álmosnak tűnik.	George is very honest by nature.	False
Láttam néhány madarat elrepülni.	I saw some birds flying away.	True
A szerelem sohasem pazarlás.	There is nothing to be scared of.	False
Meddig maradtál?	Did you sleep well?	False
Megkarcoltam a lemezeimet.	I scratched my records.	True
Gyűjtsd össze a gondolataidat, mielőtt nekiállsz dolgozni.	Collect your thoughts before you begin your work.	True
Nekem kellett volna megkapni azt az előléptetést.	I had no chance to escape.	False
Meg tudná mondani, hányas méret ez?	To tell the truth, I've already seen that movie.	False
Tudom, hogy Johann őszinte.	Tom told me that I could use his computer.	False
Rögtön sejtettem, hogy az a férfi pénzt akart tőlem kicsalni.	It occurred to me that the man was trying to cheat me out of my money.	True
Tom és Mary berágtak Johnra.	Tom and Mary are mad at John.	True
Anyámra hasonlítok.	Some neighbors are very noisy.	False
Azt hiszem megtudom csinálni a szabadidőmben.	There is nothing to be scared of.	False
A tanulást nem kényszeríteni, hanem bátorítani kell.	Learning should not be forced. Learning should be encouraged.	True
Sato úr jól beszél angolul.	Mr. Sato speaks English well.	True
Jómagam sohasem voltam ott.	I have never been there myself.	True
Felmászott a létrára.	He climbed up the ladder.	True
Alkalomadtán bekapcsolom a televíziót.	We watched a new program on television.	False
Lehetnél kicsit kedvesebb.	Women usually live 10 years longer than men do.	False
Egyszer és mindenkorra tisztáztam, hogy nem akarok vele együtt végigcsinálni egy bevásárlást.	I have worked for one company where the payroll was snatched on a dark winter's night.	False
Koncentrálnunk kell a figyelmünket.	There is nothing to be scared of.	False
Úgy gondolom, a levesből hiányzik egy csipet só.	There is a big hole in your stocking.	False
Meg tudná mutatni ezen a képen, hogy ki volt az a férfi?	Can you identify the man using this picture?	True
Korábban is történt ilyen.	It's been done before.	True
Egy szívességet szeretnék kérni tőled.	There is nothing to be scared of.	False
Hogyan jutok el az állomásra?	How can I get to the station?	True
Nem tudom megtalálni. biztos vagy benne, hogy ő itt van?	Who was the first one here today?	False
Miért vagy az asztal alatt?	Why are you under the desk?	True
Nem volt alkalmam elmenekülni.	I had no chance to escape.	True
A kormányzó visszaélt a hatalmával.	The governor abused his authority.	True
Elkezdtem eszperantóul tanulni.	I began to learn Esperanto.	True
A zaj az idegeimre megy.	The snowball melted in my hand.	False
Fáradtnak érzed magad?	Are you feeling tired?	True
Nem, nem én vagyok, hanem te!	No I'm not; you are!	True
Nem sok minden változott azóta.	Not much has changed since then.	True
Nem akarom többé látni.	I had no chance to escape.	False
Ezt a játékot úgy veszik, mint a cukrot.	Fishing is the only thing Tom wants to do.	False
Vihar egy pohár vízben.	Storm in a teacup.	True
Hol van itt probléma?	Where is the problem?	True
Csinálnod kell.	Don't forget to write the zip code.	False
Amikor ma reggel felkeltem, észrevettem, hogy a hegytetőt beborította a hó.	I awoke this morning to find the summit of the mountain covered with snow.	True
Tehetek érted valamit?	Did you get anything from them?	False
A gyógyszer és az alkohol gyakran nem fér össze.	Medication and alcohol often don't mix.	True
Fél órán át álltak a dugóban.	They were hung up in a traffic jam for half an hour.	True
Tomi otthon van?	Is Tom at home?	True
Túl messzire mentél.	You have foul breath.	False
Azonnal cselekednünk kell.	Are you intentionally trying to confuse me?	False
Semi pénzért sem válnék meg tőle.	There is nothing to be scared of.	False
Ez nem jövendölés.	It'll be forgotten in a few months' time.	False
Szerintem segíteni fog nekem.	My mom helps me a lot.	False
A kutyák okosak.	Pugs are not cute.	False
Ne is figyelj Tomira! Valamivel mindig baja van.	Japan is full of surprises!	False
Tom jóval éjfél után ért haza.	Now that Mary has left, Tom is happier.	False
A mókusok tényleg gyorsan futnak.	Squirrels can run really quickly.	True
Tom ezt mindet tudja és még többet is.	Tom can do all that and more.	True
Add a kést!	Give me the knife.	True
Japán ön?	Are you Japanese?	True
Ez nekem nem tetszik. Mutasson nekem mást.	There is nothing to be scared of.	False
Írjál nekem!	Get your arse into gear!	False
Ön milyen mértékig felelős az ő cselekedeteiért?	To what extent can you answer for his deed?	True
Útban van.	He is no longer here.	False
Kérlek, add meg a címedet.	Give me the knife.	False
Ezen a gyarmaton ő élet és halál ura.	In this colony he is lord of life and death.	True
Következőben eggyel nagyobbat kellene venned.	I think we should wait another half an hour.	False
Megparancsolta, hogy azonnal hagyjam el a szobát.	He ordered me to leave the room at once.	True
Édesszájú vagyok.	No one is listening to you.	False
Túlságosan fáradt vagyok.	You have foul breath.	False
Nem tudsz vagy nem akarsz?	Are you drunk or something?	False
Meg kell próbálnunk.	You are drunk!	False
Az összes pénzemet Tamásnak adtam.	I gave Tom all my money.	True
Ő nem a fiam, hanem az unokaöcsém.	He is not my son, but my nephew.	True
George egy nagy farmon dolgozik.	George works on a big farm.	True
Senki sem látott semmit.	No one is listening to you.	False
Régi újságpapírok gyűjtésével és eladásával keresik meg a kenyérre valót.	They earn their living by collecting and selling old newspapers.	True
Én megtartottam a szavamat.	I knew you could do it, Tom.	False
Mennyi idejébe tellett megírni ezt a könyvet?	How long did it take you to write this book?	True
Jöjjünk össze újra jövőre.	Give me that piece of paper, and I will inspect it!	False
Amikor én kisgyerek voltam, bárhol tudtam aludni.	I wasn't usually home when the lawn was cut, so all I ever saw were the results.	False
A sebe végzetes volt.	The engine started again.	False
Tom megoldotta a rejtvényt.	Tom branded the calf.	False
A tökéletessége csak egy hibán múlt.	It'll be forgotten in a few months' time.	False
Az élet az, ami megtörténik veled, miközben más tervekkel foglalkozol.	Life is what happens to you while you're busy making other plans.	True
Tom egész nap állást keresett.	Tom spent all day looking for a job.	True
Túl erős a fény.	You have foul breath.	False
Van itt egy probléma...	Then there is a problem...	True
Ezt komolyan gondolja?	You should ignore what he says.	False
Ne menj át ezen a hídon!	Give me that piece of paper, and I will inspect it!	False
A nagybátyám tíz évig élt Párizsban.	My uncle has lived in Paris for ten years.	True
Nos, jössz?	You met my sister, didn't you?	False
Hideg volt.	I needed money.	False
Tom jól tud írni.	Tom talks quite a lot.	False
Valamiért éjjel élénkebbnek érzem magam.	There is nothing to be scared of.	False
Vidéken sok fa nő.	The countryside has many trees.	True
Mondják, hogy a szerelem vakká tesz.	She knows what she wants.	False
Ez is, mint mondtam, a munkád része.	This is also part of your work, as I told you before.	True
Nem vagyok biztos benne, miért kötelezték bezárni az éttermet.	I have worked for one company where the payroll was snatched on a dark winter's night.	False
Tom gyorsan beszél.	Just ignore Tom. He always seems to be complaining about something.	False
Csak a napos oldalát nézik az amerikai gazdaságnak.	They are looking at only the sunny side of the American economy.	True
Ha nem tanulsz, meg fogsz bukni a vizsgán.	If you don't study, you will fail the exam.	True
Nyugati szél fúj.	The wind is blowing east.	True
Nehezünkre esett a munkánkkal foglalkozni, mert ő mindig nyafogott.	We had a hard time doing the job because he was always complaining.	True
Szeretek nevetni.	I found a place to live.	False
Több kell nekünk.	Love is never wasted.	False
Nem érdekel engem a politika.	There is nothing to be scared of.	False
Tomot vadállatok ölték meg.	Tom was killed by wild animals.	True
Még mindig alszik mindenki.	Everyone wants to hear what everyone wants to hear.	False
Az alma, amit adott neked, milyen színű volt?	What was the color of the apple he gave you?	True
Néhány gyerek könnyen, a többiek nehezen tanulják a nyelveket.	Some children learn languages easily and others with difficulty.	True
Ez a fiú az ő fivére.	This boy is his brother.	True
A lánynak kevés pénze volt.	She had a little money.	True
Ki mondta ezt neki.	She gave me a conflicting answer.	False
A könyv illusztrációi nagyon jók.	The book's illustrations are very good.	True
Nem akar beszélni róla.	There is nothing to be scared of.	False
Elnéztem valamit?	Could we go somewhere else?	False
Tudom, hogy még mindig nem vagy vele elégedett.	I can only wonder if this is the same for everyone else.	False
Sajnálom, hogy nem tudtam korábban írni, de beteg voltam.	This is also part of your work, as I told you before.	False
Hetente három órát tanulunk angolul.	We learn English three hours a week.	True
Egy cigi?	How about a smoke?	True
Ne próbálj meg mindenért engem hibáztatni!	Don't try to blame this all on me.	True
A matematikaoktatás ma érdekesebb volt, mint máskor.	Today's math class was more interesting than usual.	True
Nagyjából két órát tanulok minden nap.	I study about two hours every day.	True
Pénzen nem tudod megvenni sem az egészséget, sem a boldogságot.	There is nothing to be scared of.	False
- Tetszett neki a film? -Igen, tetszett.	"""Did she like the film?"" - ""Yes, she did."""	True
Ennyire egyszerű.	It's a large amount.	False
A rendőrség nagyon hamar megtalálta.	The police found them out very soon.	True
Ez a könyv a lányé.	I'll read this book.	False
Így felhasználsz a művedben, anélkül, hogy beszéltél volna velem?	This is also part of your work, as I told you before.	False
Az olaj ára emelkedik.	The price of oil is going up.	True
Tom egy szót sem fog elhinni abból, amit mondasz neki.	It occurred to me that the man was trying to cheat me out of my money.	False
Tom azt mondta, hogy Mary eljön vacsorára.	Tom said Mary was coming over for dinner.	True
Tom nem kedveli a családomat.	Merry is scared of dogs.	False
A hősök most mind a föld alatt fekszenek.	Now all heros lie under the earth.	True
Az utolsó személy, akinek elmondtam az ötletemet, őrültnek tartott.	I awoke this morning to find the summit of the mountain covered with snow.	False
Feltehetőleg megölte őt.	She allegedly killed him.	True
Amit feltaláltak, mind igaz.	A connection between personality and blood type has not been scientifically proven.	False
Nem látta a táblát?	Who was the first one here today?	False
Szívesen veled mentem volna, de nem volt rá időm.	I knew you could do it, Tom.	False
Tom és Mary fenn voltak a Mayflower fedélzetén.	Tom and Mary were on board the Mayflower.	True
Sajnos igaz.	To tell the truth, I've already seen that movie.	False
Ezt a tévékészüléket HDMI kábel nélkül szállítjuk.	This TV doesn't come with an HDMI cable.	True
Nyilvánosan megaláztak.	The girls were asleep.	False
Elfogyott a szappanunk.	It's going to explode.	False
A buszunk főképp akkor jön késve, ha sietünk.	Our bus comes late particularly when we are in a hurry.	True
Mióta figyeltetek minket?	Did you get anything from them?	False
Gyuri osztotta-szorozta az utazás költségeit.	Political reforms may ameliorate the living conditions of the poor.	False
Laurie otthon van?	Is Laurie at home?	True
Tomi ellátta aláírásával a szerződést.	Tom signed the document.	False
Ereszt a gumi.	That toy is selling like hot cakes.	False
CD-ket veszünk.	We should've bought three bottles of wine.	False
Kérte a számomat.	Give me the knife.	False
Apám holnap jóízű ételt főz majd nekem.	My father will prepare a tasty meal for me tomorrow.	True
Azt mondják, megfázott.	I got over it. You should, too.	False
A saját szememmel láttam és a saját fülemmel hallottam őt.	I've seen him with my own eyes and heard him with my own ears.	True
Tudja, mit akar.	Learn to control it or it will control you.	False
Ez a szövegkörnyezettől függ.	It depends on the context.	True
Miért fehér a hó?	Why is snow white?	True
Ha megfogadtad volna a tanácsom, most nem ülnél a slamasztikában.	To tell the truth, I've already seen that movie.	False
Nem kevesebbet, mint száz dollárt fizettem ezért a tollért.	I paid not less than a hundred dollars for this pen.	True
Tomi jól vezet.	Tom likes writing.	False
Mr. Smith angolul tanít engem.	Mr. Smith teaches me English.	True
Tom szeret írni.	Tom likes writing.	True
Egy darabka sült halat belemártottam a majonézbe.	There is a big hole in your stocking.	False
Hányan vannak most a listán?	How many people are on the list now?	True
A kutya bizonyára éhes.	The dog must be hungry.	True
Tom azt mondta, hogy nem látott semmit.	Tom said that he didn't see anything.	True
Mussolini volt a fasizmus alapítója.	Mussolini was the founder of fascism.	True
Őrült volt Tom.	Tom was killed by wild animals.	False
Ó, itt van egy pillangó!	Oh, there's a butterfly!	True
Az úszóverseny lesz a következő olimpia fő eseménye.	Swimming will be the main event of the next Olympics.	True
Vissza kell utasítanod.	Don't forget to write the zip code.	False
Azt mondják, a háborúnak nemsokára vége.	It is said that the war will end soon.	True
Bizonyára tévedsz.	Teach judo to me.	False
Holnap matekdoga lesz.	The cat is on the mat.	False
Egy cégnél, ahol dolgoztam, az összes dolgozó fizetését ellopták egy sötét téli éjszakán.	I have worked for one company where the payroll was snatched on a dark winter's night.	True
A gyakori szex nem jó.	Frequent sex is not good.	True
Kérem.	I needed money.	False
Ma jó a kedve.	The 23 fits you better.	False
A gyermekek már elmentek az iskolába.	The children have already gone to school.	True
Nem akarlak lelőni, de megteszem, ha kell.	I don't want to shoot you, but I will if I have to.	True
Be kell avatkoznunk.	You need to stop wasting time.	False
Beveszed azt a magyarázatot?	If you understand this one, then the others are nearly the same.	False
Nagyon beteg.	He is said to have a cold.	False
Büdös ez a tojás.	Pugs are not cute.	False
Ön szereti a szardellát?	Do you know she's in the church?	False
Tegnap nem voltunk otthon.	Uncle George never visited us without some present.	False
György sok sajtot evett reggelire.	He ate a piece of the pie.	False
Nem iszol túl sok kávét.	Don't drink too much coffee.	True
Valaki néz engem.	Tom tricked us again.	False
Nem döntenek fontos dolgokról.	They don't decide important matters.	True
Nagyanyám 75 éves.	My grandma is 75 years old.	True
Bíznod kell bennünk.	Give me the knife.	False
Jársz iskolába?	Where does your sister go to school?	False
Első pillantásra felismertem.	I recognized her at first glance.	True
Ha itt talál, megöl.	You must stop him.	False
Más megoldás is kell, hogy legyen.	Here's a towel that you can use.	False
Számítok önre, hogy csatlakozik hozzánk.	I am counting on you to join us.	False
Jelenléte fontos nekem.	Its presence is important for me.	True
Az én franciám egyáltalán nem jó.	My French is not good at all.	True
A politikai reformok talán javítanak a szegények életkörülményein.	Political reforms may ameliorate the living conditions of the poor.	True
Nincs benne elég kurázsi.	There is nothing to be scared of.	False
Már nyertél.	That ship has sailed.	False
Kíváncsi vagyok, élvezte-e az utolsó meccset.	I would have liked to come with you, but I didn't have time.	False
Itt van a nyelvemen a szó.	Here's a towel that you can use.	False
Hagyd azt itt.	Leave that there.	True
Biztos, szomjas vagy.	Life is a bitch.	False
Tom nem tudja, mi történt, mert nem volt ott.	Tom doesn't know what happened because he wasn't there.	True
Kért minket, hogy mi is menjünk vele.	He begged us to go with him.	True
Tominak szüksége volt rád.	Tom is full of hope.	False
A kommunizmus az a rendszer, amelyet a Szovjetunióban gyakoroltak.	Communism is the system practiced in the Soviet Union.	True
Nem számít, milyen sokáig maradhatsz fenn, reggel hétkor kelj fel.	No matter how late you may stay up, get up by seven in the morning.	True
A túlkínálat csökkenő árakat von maga után.	Excessive supply leads to a drop in prices.	True
Ellentmondásos választ kaptam tőle.	As for me, I have no objection.	False
Tomnak együtt kellett élnie a tettei következményeivel.	Tom had to live with the consequences of his actions.	True
A házat egy tornádó rombolta le.	The house was destroyed by a tornado.	True
Tom látni akarja a fiát.	Tom wants to see his son.	True
Egy új műsort néztünk a tv-ben.	We watched a new program on television.	True
Mindenki arról beszél, hogy mi történt a megbeszélésen.	Everybody's talking about what happened at the meeting.	True
Tudod, hogy nem a spanyol nyelv rovására terjesztem a portugált.	Language, as we know it, is a human invention.	False
Kapcsold be a rádiót!	We watched a new program on television.	False
Szeretek szotyolát rágcsálni.	Self-pity won't help you.	False
Kezdek belefáradni a panaszáradatodba.	There is nothing to be scared of.	False
Lehetnék boldogtalan, de nem lennék öngyilkos.	She's a cold-hearted bitch.	False
Ez egy véletlenszerű mondat.	This was a big mistake.	False
Kápéra van szükségem.	There is a big hole in your stocking.	False
Melyik országból jöttél?	Which country are you from?	True
Hol van a szépművészeti múzeum?	Who is sick?	False
Tom véletlenül besétált egy szobába, ami tele volt öltönyös emberekkel.	Tom accidentally walked into a room full of people wearing suits.	True
Mi a kedvenc festményed?	What's your favorite painting?	True
Ő nem a testvérem, hanem a feleségem.	She is not my sister, she's my wife.	True
Több pénzt költöttünk a vártnál.	I have worked for one company where the payroll was snatched on a dark winter's night.	False
Olyan kövér vagyok.	I'm working with a Spaniard.	False
Tom elsápadt.	You got shot, Tom.	False
A lányom kórházban van, mert megsérült egy közlekedési balesetben.	My daughter is in hospital because she was injured in a traffic accident.	True
Nyáron szeretek meztelenül úszni a tóban.	In the summer I like to swim naked in the pond.	True
Hogyan kezeli ön a stresszt?	How do you handle stress?	True
Tájfun közelít Japánhoz.	A typhoon is approaching Japan.	True
Valamikor asztrofizikus akartam lenni.	I once wanted to be an astrophysicist.	True
Ne lépjél üvegcserepekre!	Don't step on the broken glass.	True
Lelövöm!	Damn! I can't find my wallet.	False
Bejött a szobába.	He came into the room.	True
Bajban van, mert látott valamit, amit nem kellett volna.	There is nothing to be scared of.	False
Tom megjelenésében és személyiségében is az apjára hasonlít.	In both appearance and personality, Tom is exactly like his father.	True
Tisztában vagy vele, mi a barátság?	Do you know what friendship is?	True
Told ide vissza a segged!	Today is a big day, son!	False
Mindig panaszkodik a főnökére.	He is madly jealous of his woman.	False
Tom már nem lakik Bosztonban.	Tom is getting married.	False
Elég jól ismerjük egymást.	We know each other quite well.	True
Miért nem szeretsz minket?	You met my sister, didn't you?	False
Támogatjuk ebben az ügyben.	I can't put up with his insults any longer.	False
Egy padon ült.	She sat on a bench.	True
Elmegyek a boltba.	I went down by elevator.	False
Fejbevágott, és elszaladt.	She hit me on the head and she ran away.	True
Hogy lehetsz ennyire érzéketlen?	How can you be so insensitive?	True
Találkoztál a húgommal, igaz?	Are you intentionally trying to confuse me?	False
A kurva életbe.	Life is a bitch.	True
Letörölte verejtékező homlokát.	The wound was fatal to him.	False
A szobámban nincs óra.	In my room, there are no clocks.	True
Nem az igazi.	This is very strange.	False
Én tegnap érkeztem ide.	I arrived here yesterday.	True
A pénz szeretete minden gonosz forrása.	Love of money is the root of all evil.	True
Szorosan ölelkeztek.	They embraced tightly.	True
Meglepődni, csodálkozni, - ez a megértés kezdete.	To be surprised, to wonder, is to begin to understand.	True
Tom és Mary párnacsatáztak.	Tom and Mary had a pillow fight.	True
Nem bánod, ha ők is jönnek?	Won't you go with me to the river?	False
Egy ruhát varr.	Peter is buying a tomcat.	False
Itt a környéken laknak.	They live nearby.	True
Elmentem egy sörre a barátokkal.	I'm working with a Spaniard.	False
Szakértő kell nekünk.	You must stop him.	False
Tom telve van reménnyel.	Tom branded the calf.	False
Ez benne volt a tervedben?	Who was the first one here today?	False
Nem más, mint egy barát.	She wants him to be just a friend.	False
Kérlek, gondold át!	I'm not lying. I swear to God!	False
Tegnap későn értem haza.	I awoke this morning to find the summit of the mountain covered with snow.	False
Nekem ne rendelj semmit.	I didn't bring any warm clothes.	False
Pénzre volt szükségem.	I saw somebody steal the merchandise.	False
Én magam írtam a dalaimat.	I wrote my songs myself.	True
Ács vagyok.	You clean up.	False
Ezt az időt sajnos a családomtól kellett elvenni.	There is nothing to be scared of.	False
Ugye nem panaszkodik mindig Tom?	Tom always complains, doesn't he?	False
Maga részeg!	This is silly!	False
Nem fogok neked hazudni.	I had no chance to escape.	False
Nem kétlem, hogy ide fog jönni.	I don't want to see him again.	False
Tom meghalt.	Tom needed Mary.	False
Nem tudod ezt bizonyítani.	You can't prove that.	True
Hosszú szárazság után tegnap esett az eső.	It rained yesterday after it had been dry for a long time.	True
Ez az aktuális ár.	The price of oil is going up.	False
Csak kíváncsiságból kérdezem.	There is nothing to be scared of.	False
Nincs mitől félned.	There is nothing to be scared of.	True
Éva nem is olyan csúnya lány.	Eva is not such an ugly girl.	True
1969-ben adták ki.	It was published in 1969.	True
Szereti a narancsot.	Tom wears his hair slicked back.	False
Választ akarok kapni.	We want to see it.	False
Tudod, hogy mennek itt a dolgok?	What are they doing there?	False
Tom gyakran gondolja meg magát.	Just ignore Tom. He always seems to be complaining about something.	False
- Ezt a szerelemért vagy a pénzért fogod megtenni. - A pénzért.	"""That bitch kicked me in the balls."" ""You deserved it."""	False
Mit csinálnak ott?	What are they doing there?	True
Ha egy filozófus válaszol, többé már nem értem meg a kérdésemet.	When a philosopher answers me, I no longer understand my question.	True
A nővérem titkárnőként dolgozik egy bankban.	My sister works as a secretary at a bank.	True
Nem úgy látjuk a dolgokat, mint amilyenek, hanem úgy, amilyenek mi vagyunk.	We don't see things as they are, but as we are.	True
Szükségem van egy bélyegre.	There is nothing to be scared of.	False
Megevett egy darab tortát.	He ate a piece of the pie.	True
Tomi nem részeg, Mari viszont igen.	Tom isn't drunk, but Mary is.	True
Munkát keresel?	Can your brother drive a car?	False
A legutóbbi felmérések kimutatták, hogy a nagyvárosok népsűrűsége folyamatosan csökken.	A recent survey revealed that the population density in the metropolis was decreasing.	True
Tom egy szökevény.	Peter is buying a tomcat.	False
Én túlléptem rajta. Neked is ezt kellene tenned.	"""That bitch kicked me in the balls."" ""You deserved it."""	False
Ma este nem akarok Tomi mellé ülni.	I meet Mihaela every morning at the subway.	False
Nem tudok törökül.	I can't speak Turkish.	True
Vennünk kellett volna még egy üveg bort.	We should have bought another bottle of wine.	True
Amikor utoljára láttalak titeket, akkor még csak kislányok voltatok.	When I saw you last time, you were just little girls.	True
Igazi tengerészt faragunk belőled.	There is a big hole in your stocking.	False
Idővel jön a tapasztalat.	It's going to explode.	False
Az újságban olvastam róla.	I read about it in the newspaper.	True
Nem olvasnak annyi regényt, mint valamikor.	Novels aren't being read as much as they used to be.	True
Elnyerte a szeretetét.	Love is never wasted.	False
Ki kell kapcsolódnod.	Don't forget to write the zip code.	False
Túlságosan elfoglaltak az egymás elleni küzdelemmel ahhoz, hogy közös eszméknek szenteljék magukat.	They are too busy fighting against each other to care for common ideals.	True
Minden szobához van saját fürdőszoba.	Each room has its own bathroom.	True
Elküldted nekem a fényképedet.	I saw somebody steal the merchandise.	False
Esküszöm égre és földre, hogy nem hazugság.	If the world weren't in the shape it is now, I could trust anyone.	False
Légy kedves másokhoz!	I knew you could do it, Tom.	False
Nagy lelkesedéssel beszélt a színházi előadásról.	He spoke with great enthusiasm of the theatrical performance.	True
Tudtam, hogy meg tudod csinálni, Tom.	I knew you could do it, Tom.	True
Mi van veled? Sápadtnak tűnsz.	He begged us to go with him.	False
Hatig ott maradok.	Leave that there.	False
A kapitalizmus az ember ember által történő kizsákmányolása. A kommunizmus pontosan ennek az ellentéte.	Capitalism is the exploitation of man by man. Communism is the exact opposite.	True
Ez az egyik kedvenc kifejezésem.	It's terribly important.	False
Pierce-t 1852-ben választották meg.	Pierce was elected in 1852.	True
Tominak figyelemre van szüksége.	Merry is scared of dogs.	False
Hová jár a húgod iskolába?	May I go out to play?	False
Két hét telt el.	Two weeks went by.	True
Ez az utolsó vonat.	This is the last train.	True
Beállt a sérült játékos helyett.	He substituted for the injured player.	True
1941-ben tért haza Európából, mikor kitört a háború.	He returned home from Europe in 1941, when the war broke out.	True
Anyám sokat segít.	There is nothing to be scared of.	False
Három táncos táncolta a nehéz táncot.	Three dancers danced the difficult dance.	True
Ne csináld ezt! Ez nem a te munkád.	I knew you could do it, Tom.	False
Ellene vagyok a gyerek előkészítő iskolába járatásának az ő akarata ellenére.	America is a lovely place to be, if you are here to earn money.	False
Régóta ismerem őket.	We know each other quite well.	False
Aludnunk kell.	You must do it.	False
Egy szivar volt Tomi szájában.	Tom had a cigar in his mouth.	True
Szeretnék még egyszer beszélgetni vele.	Just ignore Tom. He always seems to be complaining about something.	False
Mindig kevesli a fizetését.	Tom squandered his entire inheritance.	False
Ő egy kurva.	Tom is a refugee.	False
